111111
111111
100001
1P00E1
1111a1