11111111111111111
10C000001C0000001
10010101000C00101
1P0000000001000E1
11111100000000001
11111111111111111