111111
111111
100C01
1P00E1
111110