11111111111111111
10C000001C0000001
10010101000C00111
1P0000000001001E1
111111000000000C1
11111111111111111