11111111111111
100000000CC001
1P0C00E0000001
10000000001101
100CCC00000001
11111111111111