111111
1001C1
100101
1P00E1
111111