111111
100P11
10C001
1P1001
1000E1
111111